好马不吃回头草	a good man doesn't backtrack
小菜一碟	a piece of cake
太阳从西边出来	hell freezes over
说曹操，曹操到	speak of the devil
乌鸦嘴	jinx
二百五	halfwit
吃一堑，长一智	a fall in the pit
睁着眼睛说瞎话	to flout reality
近朱者赤，近墨者黑	one is marked by the company one keeps
物以稀为贵	that which is rare is dear
王婆卖瓜，自卖自夸	every potter praises his own pot
站着说话不腰疼	talk is cheap
天下没有不散的筵席	all good things must come to an end
天上掉馅饼	to have something fall into your lap
巧己所不欲，勿施于人	do unto others as you would have them do unto you
睁眼瞎	a bad judge of character
跳进黄河洗不清	to be unable to clear one's name
拍马屁	to suck up to
情人眼里出西施	love is blind
打酱油	I couldn't care less
不怕一万，就怕万一	one can never be too careful
走着瞧	wait and see
不管三七二十一	to act recklessly
吃着碗里的，看着锅里的	to be unsatisfied with what one has
钻牛角尖	to split hairs
人不可貌相，海水不可斗量	you can't judge a book by its cover
林子大了，什么鸟都有	there are all kinds of fish in the sea
鸡毛蒜皮	trivial
鲜花插在牛粪上	a beautiful woman is married to an old/ugly man
醉翁之意不在酒	to have an ulterior motive
猴年马月	god know when
眼不见为净	what somebody doesn't know/see can't hurt them
姜是老的竦	with experience comes wisdom
得青山在，不怕没柴烧	where's there's life there's hope
拿得起，放得下	to be able to go with the flow
以其人之道还治其人之身	to give someone a taste of their own medicine
走桃花运	lucky in love
成事不足，败事有余	incompetent
皇上不急太监急	the person involved is calm and collected but observers are very worried
三个臭皮匠，顶个诸葛亮	two heads are better than one
脚踩两只船	to have a foot in both camps
此地无银三白两	telltale sign
吃不到葡萄就说葡萄酸	sour grapes
心急吃不了热豆腐	more haste less speed
家常便饭	run of the mill
癞蛤蟆想吃天鹅肉	to be out of one's league
天无绝人之路	there is always a way out
走后门	get in through the back door
瞎猫碰上死耗子	even a broken clock is right twice a day
好汉不吃眼前亏	discretion is the better part of valor
解铃还须系铃人	he that hides can find
肥水不流外人田	one does not allow benefits created by one's own work to accrue to others
心有余而力不足	run out of steam
不分青红皂白	indiscriminate
睁一只眼，闭一只眼	to turn a blind eye
破罐子破摔	a vicious cycle
种瓜得瓜，种豆得豆	you reap what you sow
萝卜白菜，各有所爱	different strokes for different folks
狗嘴里吐不出象牙	what can you expect from a hog but a grunt
三天打鱼，两天晒网	to blow hot and cold
一朝被蛇咬，十年怕井绳	once bitten twice shy
英雄难过美人关	no man can resist the charms of a beautiful woman
刀子嘴，豆腐心	to be a softie at hear
一失足成千古恨	one false step brings everlasting grief
哪壶不开提哪壶	rub someone's nose in it
炒鱿鱼	to can someone
人往高处走，水往低处流	it is in man's nature to strive for better
说得比唱得好听	to speak eloquently but untruthfully
强扭的瓜不甜	you can lead a horse to water but you can't make him drink
老掉牙	tired old
搬起石头砸自己的脚	to shoot oneself in the foot
卖关子	to leave someone hanging
一分钱一分货	you get what you pay for
九牛二虎之力	a Herculean effort
敬酒不吃吃罚酒	to acquiesce to something after having refused someone's first overture
躲得过初一，躲不过十五	you can't avoid something forever
吃香的，喝辣的	to live in the lap of luxury
小儿科	child's play
一个巴掌拍不响	it takes two to tango
牛头不对马嘴	incongrous
以小人之心，度君子之腹	to project one's shortcomings on someone
车到山前必有路	we'll cross that bridge when we come to it
鸡蛋里挑骨头	to nitpick
吃不了兜着走	to be unable to bear the consequences of failure
打肿脸充胖子	to puff oneself up at one's own cost
三十六计走为上	to get out while the going's good
当耳旁风	to roll off like water off a duck's back
恨铁不成钢	expect better from someone
你走你的阳关道，我过我的独木桥	let's go our separate ways
过了这个村，就没这个店	it's now or never
抱佛脚	to cram
有钱能使鬼推磨	money talks
有其父必有其子	like father like son
不见棺材不落泪	to hold out hope until faced with the grim reality
三长两短	god forbid anything should happen to someone
纸包不住火	the truth always comes out
好戏在后头	the best is yet to come
吹牛皮	brag
欲速则不达	more haste less speed
家家有本难念的经	we all have our burdens to bear
墙头草	fence sitter
替罪羊	sacrificial lamb
近水楼台先得月	to enjoy the benefits of a favorable position
小巫见大巫	to pale in comparison with
过河拆桥	to kick someone to the curb when they've outlived their usefulness.
一不做，二不休	in for a penny in for a pound
以牙还牙，以眼还眼跑了	an eye for an eye and a tooth for a tooth
和尚跑不了庙	you can run but you can't hide
绿帽子	cuckold
识时务者为俊杰	he who understands the times is a wise man
井水不犯河水	to stay in one's own lane
一棵树上吊死	to be inflexible and stubborn
放鸽子	to stand someone up
一步一个脚印	to take something one step at a time
上梁不正下梁歪	a crooked stick will have a crooked shadow
不入虎穴，焉得虎子	nothing good comes without risk
赔了夫人又折兵	to suffer a double loss
有心栽花花不长，无心插柳柳成荫	to unknowingly benefit from an unexpected course of events
八字还没一撇	it hasn't even begun
有眼不识泰山	to entertain angels unawares
出气筒	punching bag
八九不离十	close to the mark
无风不起浪	there's no smoke without fire
得便宜卖乖	to not admit that one has received a benefit
不是省油的灯	a real piece of work
家丑不可外扬	don't wash dirty linen in public
背黑锅	to take the rap
兔子不吃寓边草	even a villain doesn't harm the next door neighbors
铁饭碗	a cradle-to-grave job
冰冻三尺，非一日之寒	Rome wasn't built in a day
远亲不如近邻	better a close neighbor than a distant brother
下马威	opening gambit
天下乌鸦一般黑	they're all the same
不到黄河心不死	it's not over 'til it's over
狗急了跳墙	despair fives courage even to a coward
狗眼看人低	to have one's nose in the air
只许州官放火，不许百姓点灯	one may steal a horse while another may not look over a hedge
偷鸡摸狗	to pilfer
死马当活马医	to make a Hail Mary effort
新官上任三把火	to make drastic changes to an organization upon taking charge
对号入座	to make a connection
十万八千里	worlds apart
露马脚	to let the cat out of the bag
公说公有理，婆说婆有理	each side believes it is correct
上刀山，下火海	come hell or high water
打退堂鼓	to beat a retreat
磨刀不误砍柴工	a beard lathered is half shaved
风马牛不相及	as different night and day
一山不容二虎	two tigers cannot share one mountain
里揉不得沙子	to not let things slide
三下五除二	in no time (flat)
泼冷水	to pour cold water on
杀鸡给猴看	to throw the book at someone to set an example
生米做成熟饭	the die is cast
初生牛犊不怕虎	youth knows no fear
铁公鸡	miser
无事不登三宝殿	one never visits unless they need something
马后炮	to be wise after the fact
掉链子	to fumble the ball
纸老虎	paper tiger
狐狸精	vixen
丑话说在前头	let's be candid here
半路杀出个程咬金	someone threw a wrench in the works
麻雀虽小，五脏俱全	even if something is small it can still contain the essentials
虎毒不食子	even a monster would not hurt its own children
小不忍则乱大谋	a little impatience will spoil great plans
打狗还得看主人	every action has consequences
万事俱备，只欠东风	to be prepared but lack the crucial element
不管黑猫白猫，会捉老鼠就是好猫	it does not matter whether a cat is black or white so long as it catches mice
真金不怕火炼	true blue will never stain
狗改不了吃屎	the fox may grow grew but never good
杀手锏	ace in the hole
饥不择食	beggars can't be choosers
对事不对人	it's nothing personal
皮笑肉不笑	fake smile
双刃剑	double-edged sword
热脸貼冷屁股	to have someone not give you the time of day
好了伤疤忘了疼	once on shore one prays no more
醋坛子	jealous lover
君子之交淡如水	the friendship between gentlemen appears indifferent but is pure like water
三个和尚没水吃	everybody's business is nobody's business
赶鸭子上架	to force someone to put a square peg into a round hole
小白脸	pretty boy
放长线，钓大鱼	to play the long game
依葫芦画瓢	to follow suit
隔墙有耳	walls have ears
巧妇难为无米之炊	you can't make bricks without straws
不是吃素的	to be someone not to be trifled with
嫁鸡随鸡，嫁狗随狗	a woman should stand by her man
打开天窗说亮话	to lay one's cards on the table
人算不如天算	the best laid plans of mice and men often go awry
小动作	a cheap shot
远水解不了近渴	while the grass grows the horse starves
占着茅坑不拉屎	to be a dog in the manger
碰一鼻子灰	to get the cold shoulder
死猪不怕开水烫	the situation is already so bad that to make it worse makes no real difference
换汤不换药	putting old wine in new bottles
救命稻草	a straw to clutch at
明枪易躲，暗箭难防	better an open enemy than a false friend
谋事在人，成事在天	man proposes god diparesis's all in god's hands now
三个女人一台戏	three women make a market four a fair
有鼻子有眼	a word picture
枪打出头鸟	the hunter will shoot the bird that sticks out
碰钉子	to be rebuffed
蹬鼻子上脸	to go too far
吃豆腐	to take advantage of a woman
眉毛胡子一把抓	to tackle everything all at once
偷鸡不成反蚀把米	to go out for wool and come back shorn
众人拾柴火焰高	little things add up
快刀斩乱麻	to cut the Gordian knot
吃软饭	freeloader
一着不慎，满盘皆输	one false move may lose the game
听风就是雨	to jump to conclusions from insignificant evidence
鸿门宴	ambush
吃哑巴亏	to bite one's tongue
眼中钉、肉中刺	a thorn in the side
舍不得孩子套不住狼	you have to spend money to make money
挂羊头、卖狗肉	to bait and switch
煮熟的甲鸟子飞了	to slip though one's fingers
常在河边走，哪有不湿鞋	touch pitch and you shall be defiled
三脚猫	dilettantish
吃闭门羹	to be left out in the cold
三十年河东，三十年河西	change is the only constant
土包子	bumpkin
树大招风	the winds howl around the highest peaks
酒逢知己千杯少	for a good friend a thousand toasts are too few
当一天和尚撞一天钟	to go through the motions
是骡子是马拉出来遛遛	actions speak louder than words
一个鼻孔出气	to be hand in glove
身在曹营心在汉	to not have one's heart in something
瘦死的骆驼比马大	a starving camel is still bigger than a horse
树欲静而风不止	for a situation to takes it own course regardless of someone's wishes
丑媳妇早晚也得见公婆	one is unable to avoid an unpleasant experience forever
胜者王侯败者贼	winning isn't everything it's the only thing
下三烂	low-life
上了贼船	to get in too deep
病急乱投医	desperate times call for desperate measures
打如意算盘	to engage in wishful thinking
龙生龙，凤生凤	like father like son
不看僧面看佛面	for someone's sake
雷声大、雨点小	all talk no action
脸红脖子粗	flushed with excitement/agitation
一棍子打死	to throw the baby out with the bathwater
拿鸡蛋碰石头	to pick a losing battle
没有不透风的墙	two may keep counsel putting one away
人怕出名猪怕壮	fame can be a double-edged sword
山中无老虎，猴子称大王	when the cat's away the mice will play
杀鸡焉用宰牛刀	you don't need a sledgehammer to crack a nut
大树底下好乘凉	follow closely behind heavy-laden wagons
跑龙套	to be a small player
七大姑，趴大姨	extremely distant relatives
一是一，二十二	to call a spade a spade
多个朋友多条路	the more friends you have the more options you have in life
下台阶	to give someone an out
打小算盘	to act in one's own self-interest
坐山观虎	sit this one out and reap the spoils later
斗羊毛出在羊身上	there's no such thing as a free lunch
一口吃成个胖子	to wave a magic wand and get what one wants
屋漏偏逢连阴雨	when it rains it pours
老油条	wily old fox
捅马蜂窝	to stir up a hornet's nest
小意思	not a big deal
倒打一耙	to play the blame game
陈芝麻，烂谷子	idle chatter
一条龙	from soup to nuts
四两拨千斤	to solve a big issue with little effort
前怕狼，后怕虎	to be afraid to commit oneself
吃水不忘挖井人	when drinking water don't forget those who dug the well
有仇不报非君子	a real man must settle his scores
不倒翁	a tumbler
干打雷，不下雨	to talk the talk but not walk the walk
鸡飞狗跳	in a tizzy
事后诸葛亮	hindsight is 20-20
落水狗	one who is down on their luck
板上钉钉	a sure bet
一碗水端平	to be impartial
烫手的山芋	a hot potato
笑掉大牙	to laugh one's head off
一回生，二回熟	a stranger is just a friend you haven't met yet
鱼与熊掌不可得兼	one can't have everything in life
咸鱼翻身	to give a new lease on life
一根绳上的蚂蚱	to be in something together
趟浑水	to intentionally get involved in a messy situation
狗腿子	lackey
用在刀刃上	to employ limited resources where they are needed most
鸡飞蛋打	to come up empty-handed
胳膊扭不过大腿	the weak cannot contend with the strong
饱汉不知饿汉饥	the wearer knows best where the shoe pinches
笑面虎	a wolf in sheep's clothing
二	clueless
给力	awesome
母老虎	shrew
五十步笑百步	the pot calling the kettle black
门外汉	a layman
前人栽树，后人乘凉	for posterity's sake
烂泥扶不上墙	to wash a pig is to waste both water and soap
关公面前耍大刀	to teach one's grandmother how to suck eggs
高不成，低不就	to not be good enough to get what one wants but unwilling to pursue something befitting one's talents
胳膊肘往外扭	to side with outsiders instead of one's own people
长痛不如短痛	it's better to deal with painful things quickly
酒香不怕巷子深	good wine needs no bush
一条路走到黑	to be as stubborn as a mule
不是鱼死，就是网破	it's either him or me
冰山一角	the tip of the iceberg
身体是革命的本钱	good health is a prerequisite for work
说风凉话	to crack wise
紧箍咒	to tug on the yoke
唱双簧	a carefully choreographed dance
开空白支票	to make a promise one cannot keep
保护伞	something providing legal or political cover for someone
一个萝卜一个坑	each has his own task and there's nobody to spare
狗咬狗	dogfight
唱高调	to posture
打水漂	to make ducks and drakes of
开小差	to let one's mind wander
两面派	double-dealer
一盘散沙	to be in state of disunity
和稀泥	to paper over something
敲竹杠	to fleece
扯后腿	to hold someone back
穿小鞋	to stack the deck against someone
给他一点颜色看看	to take someone down a peg
天高皇帝远	when one is far away from authority the powers that be will not intervene
拣软柿子捏	to pick on an easy target
打马虎眼	to play dumb
千里马	wunderkind
打擦边球	to push the envelope
摸着而头过河	to cross the river by touching stones
半路出家	mid-life career change
老狐狸	sly old fox
一窝蜂	a swarm
开夜车	to burn the midnight oil
手心手背都是肉	a tough call
缩头乌龟	a chicken
走过场	to go through the motions
做文章	to seize on
吃大锅饭	to be compensated without regard to performance
戴高帽	to oversell something
秋后算账	revenge is a dish best served cold
僧多粥少	too many boats chasing too few fish
坐冷板凳	to be sidelined
不当家不知柴米贵	if one is not in someone else's situation one cannot understand that person's troubles
红眼病	jealousy
葫芦里卖的是什么药	to have something up one's sleeve
三句话不离本行	to hardly be able to talk about anything other than one's work
糖衣炮弹	Trojan Horse
树倒猢狲散	rats leave a sinking ship
硬骨头	a tough nut to crack
二虎相争，必有一伤	when two tigers clash
拆东墙，补西墙	to rob Peter to pay Paul
大鱼吃小鱼	the law of the jungle
狐狸尾巴露出来了	to show one's true colors
开绿灯	to give the go-ahead
歪瓜裂枣	a troll
小辫子	chink in one's armor
一头雾水	at a loss
隔行如隔山	different professions are different worlds
一亩三分地	personal fief
成也萧何，败也萧何	one's successes and failures are both due to the same person
大水冲了龙王庙	friendly fire
乱弹琴	to speak or act without sound reason
挤牙膏	to draw something out
墙倒众人推	everyone kicks a man who is down
莫须有	groundless
拿鸡毛当令箭	to use a made-up directive to order people around
捅破窗户纸	to affirm an open secret
三字经	curse
苍蝇不叮无缝的蛋	to bring bad things upon oneself as a result of one's bad character
大跌眼镜	to have one's jaw drop
说一千，道一万	there are no two ways about it
绊脚石	stumbling block
过五关、斩六将	to overcome great challenges and have the glory to show for it
求爷爷、告奶奶	to go around begging for help
羡慕嫉妒恨	to be green with envy
打掉门牙往肚里咽	to bite one's tongue
唱对台戏	to steal someone's thunder
分一杯羹	to take one's share of the loot
变色龙	chameleon
独木不成林	a single tree does not a forest make
既生瑜，何生亮	if god made someone so excellent why did he make someone even better
撂挑子	to quit one's job
敲门砖	prerequisite for
试金石	touchstone
火烧眉毛	the chips are down
空手套白狼	to gain something without risking anything of one's own
一瓶子不满，半瓶子晃荡	empty barrels make the most noise
脱了裤子放屁	as useless as tits on a bull
借东风	to ride the wave
白开水	vanilla
鲤鱼跳龙门	to get one's big break
强龙压不住地头蛇	you can't beat someone on their home turf
这山望着那山高	the grass is greener on the other side
光脚的不怕穿鞋的	he who is down need fear no fall
不成功，便成仁	to win or die trying
滚刀肉	real piece of work
久病成良医	prolonged illness makes the patient a good doctor
枕边风	pillow talk
一锤子买卖	to skin the sheep
横挑鼻子竖挑眼	to do one's utmost to find the problems where there are none
唱空城计	to bluff
一刀切	cookie-cutter
旧瓶装新酒	new content in an old form
两面三刀	two-faced
一把钥匙开一把锁	there is a key for every lock
打一巴掌，给个甜枣	to throw someone a bone
先君子后小人	let's not let this get ugly
尺有所短，寸有所长	no one is perfect but no one is worthless either
出来混的，总要还的	chickens come home to roost
画虎不成反类犬	(to try to emulate something beyond one's ability and) fall flat on one's face
大意失荆州	to suffer a serious setback as the result of a careless mistake
卸磨杀驴	to kick someone to the curb when they've outlived their usefulness
躺着都中枪	to get caught in the crossfire
脚正不怕鞋歪	an honest man fears no gossip
有奶就是娘	to sell one's allegiance to the highest bidder
肉烂在锅里	it's all in the family
说你胖你就喘	flattery like perfume should be smelled not swallowed
擦屁股	to clean up someone's mess
皇帝女儿不愁嫁	sitting pretty
一朝天子一朝亞	new leaders appoint new counsellors
活人让尿憋死	to not be adaptable
走马灯	incessant turnover of personnel
花无白日红	nothing good lasts forever
东风压倒西风	the good guys win
岁月是把杀猪刀	time isn't kind to anyone
丁是丁，卯是卯	to be meticulous
多年的媳妇熬成婆	to have paid one's dues and get what one deserves
强将手下无弱兵	there are no poor soldiers under an able general
头痛医头，脚痛医脚	to slap a Band-Aid on something
拉不出屎来怨茅房	a good carpenter doesn't blame his tools
东方不亮西方亮	while something isn't workable in one place it might be workable somewhere else
老牛拉破车	to trundle along
放卫星	to talk the talk
鸡同鸭讲	whistling in the wind
一锅端	to be wiped out all at once
老皇历	anachronistic
家花没有野花香	the grass is always greener (on the other side of the fence)
又想当婊子又想立牌坊	to want to be able to do immortal things while maintaining a good name
遮羞布	a fig leaf
耍花枪	to toy with someone
又要马儿跑，又要马儿不吃草	to have one's cake and eat it too
牛不喝水强按头	to impose one's will on someone
摆乌龙	made a mistake
各打五十大板	to punish both parties equally without considering guilt
一个将军一个令	new lords new laws
抱大腿	to cozy up to someone powerful
砸了锅	to drop the ball
会哭的孩子有奶吃	the squeaky wheel gets the grease
二一添作五	go fifty-fifty
风一阵，雨一阵	to flit from one thing to another
剃头挑子一头热	not having any of it
远来的和尚会念经	all that is foreign must be better
揪辫子	to seize on someone's shortcomings
小姐的身子丫鬟的命	a good lady with bad fortune
只见树木，不见森林	to not see the forest for the trees
屁股决定脑袋	one's position determines one's views and behavior
兔子尾巴长不了	something's days are numbered
骑马找马	to look for another job while keeping one's current position
敲锣边儿	to stir the pot
扣帽子	to paint someone as something
拨出萝卜带出泥	one thing brings about another
满嘴跑火车	to blow smoke
温水煮青蛙	to boil the frog slowly
万金油	panacea
树挪死，人挪活	people unlike trees thrive on change
按下葫芦起了瓢	to be like Whac-A-Mole
到什么山唱什么歌拔	to change one's tune when talking to different people
根汗毛比腰粗	to be significantly richer or more powerful than others
阎王好见，小鬼难搪	getting past the gatekeeper is the hard part
不见兔子不撒鹰	to not commit oneself until success is certain
当面锣，对面鼓	to has things out in the open
眼大肚子小	to have eyes bigger than one's stomach
浅水养不了大鱼	a big fish needs a big pond
吃别人嚼过的馍不香	if you're not the first you're the last
起大早，赶晚集	first off the blocks but last over the line
打不着狐狸惹身骚	to wake a sleeping giant
多面手	polymath
鸟枪换炮	to be moving on up
矬子里拔将军	in the land of the blind the one-eyed man is king
给个棒槌就当针	to take something too literally or seriously
捧臭脚	to lick someone's boots
咬人的狗不露齿	beware of a silent dog and still water
炒冷饭	to rehash
一只羊是赶，一群羊也是放	what's one more
虱子多了不咬，账多了不愁	worry is interest paid on trouble before it is due
攒鸡毛，凑掸子	quantity does not make up for inferior quantity
骑脖子拉屎	to treat someone like garbage
指着和尚骂秃子	thinly veiled criticism
蚂蚱也是肉	a buck is a buck
背着抱着一般沉	six of one half a dozen of the other
一言堂	an area where one person's words goes
乱拳打死老师傅	an inexperienced person defeats a master by throwing out the rules of traditions
端起碗来吃肉，放下筷子骂娘	to drink the ocean and then call it salty
出头的椽子先烂	the nail that sticks out gets hammered down
一马勺坏一锅	one bad apple spoils the barrel
终日打雁，让雁啄了眼	the hunter becomes the hunted
老鸹嫌猪黑	it's the pot calling the kettle black
别人牵驴你拨橛	to get caught holding the bag
仔卖爷田不心疼	to sell one's birthright for a mess of pottage
萝卜快了不洗泥	the hasty bitch brings forth blind puppies
接地气	grounded
装逼	posture
牛逼	impressive
异世	alternate world
太古	primordial
上古	ancient
舍利	relic
试炼者	trial-takers
丈	ten feet
打量	sized up
空间戒指	interspatial ring
法则	laws
法则领悟	nomological insight
法器	Dharma artifact
法宝	Dharma treasure
法术	Dharma spells
法力	Dharmic powers
法门	Dharmic formulation
周天	Heavenly Cycle
道藏楼	Dao Repository
灵丹	Spirit Pills
灵石	spirit stones
修行界	cultivation world
地火	Earth fire
葫	Calabash
超品	transcendent-grade
飞剑	flying sword
道符	Dao talisman
道法	Dharmic Dao
道域	Dao domain
定身术	Immobilizing Spell
祸害	wreaked havoc
传音	a voice transmission
散修	itinerant cultivator
图录	totem
血髓	blood marrow
热血沸腾	ardor and zeal coursing through their blood
青龙	azure dragon
朱雀	vermilion bird
提炼	extraction
金乌	Golden Crow
神魔	Godfiend
家族	family clan
女帝	Great Empress
随意	nonchalantly
老祖	Patriarch
老族长	Patriarch
峰	peak
师公	Grandmaster
师爷	Grandmaster
师侄	Disciple-Nephew
师弟	Junior Brother
师兄	Senior Brother
师姐	Senior Sister
师妹	Junior Sister
师姑	Aunt-Master
师叔	Uncle-Master
师博	Uncle-Master
师父	Master
前辈	Senior
晚辈	Junior
蛊	Gu
关门弟子	final disciple
亲传弟子	personal disciple
直传弟子	inherited-teachings disciple
记名弟子	in-name disciple
核心弟子	core disciple
外门弟子	outer sect disciples
内门弟子	inner sect
长老	Elder
太上长老	Grand Elder
门主	sect master
教主	sect master
弟子	disciple
公子	Young Master
阵盘	formation disk
洗精伐髓	Marrow Cleansing
经脉	meridians
任督二脉	conception and governor vessels
拳法	fist techniques
秘法	mystic technique
药渣	herbal dregs
功法	cultivation technique
便宜你	you lucked out
白活	lived in vain
中土	heartlands
化形	manifestation
祖器	ancestral artifact
公爵	duke
侯爵	marquis
伯爵	earl
子爵	viscount
男爵	baron
秘境	mystic realm
离火	Li Fire
三足	three-legged
器灵	Item Spirit
天道	Heavenly Dao
纯阴	pure Yin
纯阳	pure Yang
混沌鸿蒙	Primordial Chaos
联盟	alliance
灭世狼烟	Apocalyptic Fumes
怪不得	It was no wonder
一览	a mere glance
按照	according to the
合乎情理	well within reason
撒娇	wheedle
除了	Apart from
自幼	at a very young age
一脸无辜	gave a perfectly guileless look
游山玩水	jaunt
和睦	rapprochement
剑道	Sword Dao
孤阴不长，独阳不生	Lone Yin did not lead to birth and solitary Yang did not allow growth
太乙	Primordial Unity
乾坤袋	Cosmic Bag
妖	demon
魔	fiend
邪	heretic
闭关	seclusion
魔仆	demonic servant
宁静	placid
迷离	dazed
恍惚	adrift
丹田	dantian
迷蒙	misty
九婴	Nine Neonate
极品	supreme-grade
两败俱伤	internecine outcome
转世者	Reincarnators
君王	sovereign
空间节点	spatial node
剑心	Heart of the Sword
剑意	sword intent
剑灵	sword spirit
剑魂	sword soul
悟道	enlightenment
阵法	array formation
陛下	Your Majesty
娘娘	Her Majesty
空间法则	spatial dimension laws
小丫鬟	maidservant
斜眼	looked askance
眉心	glabella
火系法则	fire-elemental laws
蛟	wyrm
体魄	physique
吐血	vomiting blood
吞噬法则	engulfing law
中年人	middle-aged man
血脉	bloodline
顿悟	epiphany
胖子	Fatty
战斗技巧	combat skill
防术	defensive skill
身法	movement technique
战技	offensive skill
贞洁	Chastity
节制	Temperance
慷慨	Charity
勤奋	Diligence
耐心	Patience
宽容	Kindness
谦逊	Humility
傲慢	Pride
嫉妒	Envy
暴食	Gluttony
色欲	Lust
暴怒	Wrath
怠惰	Sloth
贪婪	Greed
施主	Benefactor
会心一笑	gave a knowing smile
菩提树	bodhi tree
阿弥陀佛	Amitabha
菩萨	Bodhisattva
禅师	Zen Master
法眼	Dharma Eyes
后天	Postnatal
先天	Connate
实丹	True Core
虚丹	False Core
金丹	Golden Core
修仙人	immortal cultivator
修行人	cultivators
名妓	renowned courtesans
两银子	taels of silver
主持	abbot
庵	convent
庙	temple
寺	monastery
点头道	nodded and said
拉倒吧	forget it
手机	cell phone
救人一命胜造七级浮屠	Saving a life is better than building a seven-storied pagoda
天眼	Heavenly Eye
正道	orthodox
邪道	unorthodox
天仙	Skyimmortal
真仙	Perfected Immortal
金仙	Golden Immortal
大罗	Zenith Heaven
圣人	Saint
三千大世界	Trichiliocosm
法门		Dharmic formulation
葫		Calabash
道心	Dao Heart
道果	Dao Fruit
道种	Dao Seed
道树	Dao Tree
魔神	fiendcelestial
甘霖符	Drought Rainfall Charm
护甲术	Protective Armor Spell
妖魔	fiendish demon
道人	Daoist
城主	City Lord
大巫	Grand Magus
巫派	Magus Sect
巫姥	Magistress
天巫	Heaven Magus
巫女	Magus Maiden
水族	Water race
天地之力	Heaven and Earth powers
郡守	Prefectural Governor
郡	prefecture
郡城	prefectural city
县城	county city
县	county
州	state
省	province
游丝	Gossamer
御史台	Censorate
阁老	Cabinet Elder
巡按	Roving Censor
左都御史	Left Censor-in-Chief
监察御史	Monitor Censor
州牧	State Overseer
御剑飞行	Sword Kinesis Flight
技近乎道	Expertise Nearing Dao
峰		peak
祖师	Ancestral Master
蛊		Gu
直传弟子	direct disciple
门主		sect master
阵盘	array disk
拳法	fist arts
秘法	mystic arts
圣人	sage
王		prince
器灵	Artifact Spirit
太乙	Great Unity
斩马刀	Steed-slaying Saber
关刀	glaive
三节棍	nunchucks
血滴子	flying guillotine
尺		ruler
扇		fan
丝带	ribbon
锥		awl
飞刀	flying daggers
狼牙棒	barbed mace
如意	Ruyi scepter
符		talisman
拂尘	whisk
玉简	jade slip
刀		saber
枪		spear
棍		pole/staff
杖		staff
妖		demon
魔		fiend
邪		heretic
剑域	sword domain
蛟		flood dragon
施主	Patron
元婴	Nascent Soul
凝气	Qi Condensation
炼气	Qi Refinement
炼虚	Void Refinement
合体	Fusion
大乘	Mahayana
渡劫	Tribulation Transcendence
筑基	Foundation Establishment
结丹	Core Formation
化神	Soul Formation
婴变	Neonate Transformation
问鼎	Ascendant
阴虚	Void Yin
阳实	Materialize Yang
窥涅	Nirvana Scryer
净涅	Nirvana Cleanser
碎涅	Nirvana Shatterer
空涅	Ethereal Nirvana
空灵	Ethereal Spirit
空玄	Ethereal Profound
空劫	Ethereal Tribulation
天尊	Heavenly Venerate
踏天	Heaven Trampling
上仙	Exalted Immortal
天仙	Heavenly Immortal
仙王	Immortal King
仙君	Immortal Monarch
仙帝	Immortal Emperor
成仙	Immortal Ascension
真仙	True Immortal
天劫	Heavenly Tribulation
斩灵	Spirit Severing
古境	Ancient Realm
准道境	Quasi-Dao Realm
道境	Dao Realm
超脱境	Transcendence
道源境	Dao Source
至尊	Paragon
问道	Dao Seeking
祖境	Ancestor Realm
八卦	Eight Trigrams
风水	Feng Shui
阵旗	array flags
丹道	alchemy
鼎		cauldron/tripod
簋		cauldron
丹药	elixirs
药草	herbs
灵草	spirit herbs
灵宝	numinous treasure
袍		robe
联姻	marriage alliance
叩头	kowtow
抱拳	cupped fists
阁		pavilion
塔		pagoda
洞府	Cave Abode
仙子	Fairy
莲花	lotus flower
掐诀	hand seals
炼		refine
時辰	two hours
兩		tael
文		thousandth of a tael (use it judiciously)
里		500 meters
斤		500 grams
寸		inch
修行人	cultivator
名妓	renowned courtesan
三界	Three Realms
六道轮回	Six Paths of Reincarnation
业		negative karma
缘		fate
因果	karma
功德	merit
道		Dao
五行	Five Elements
镖局	Escort Agency
镖人	escort
内力	internal energy
点脉	striking the acupuncture points
经		sutra
吐纳	expiration
走火入魔		Qi Deviation
心魔	mental demons
初期	early-stage
中期	mid-stage
后期	late-stage
巅峰	peak
圆满	perfected
半步	half-step
灵宝山	Numinous Treasure Mountain
天仙	Sky Immortal
僻谷	Grain Liberation
凡人	mortal
一种修行	a form of cultivation
羿清	Yi Qing
沈萤	Shen Ying
真人	Perfected One
孤月	Lonemoon
凡界	Mortal Realm
妖王	Demon Monarch
六派三宗	Six Schools Three Sects
修士	cultivators
穿越	transmigrate
仙人	immortal
哈哈哈	Hahaha
噬魂幡	Soul Devouring Gonfalon
阵	array
芮糜	Rui Mi
玄天宗	Blackheaven Sect
灵气	Spirit Qi
妖界	Demon Realm
妖气	demonic aura
大道	Great Dao
呵呵	Heh heh
剑修	sword cultivator
冰参	Ice Ginseng
灵力	Spiritual Power
剑体	Innate Sword Embodiment
道君	Dao Lord
剑气	Sword Qi
道友	Fellow Daoist
鬼王	Ghost King
阴气	Yin Qi
魔修	Fiendish Cultivator
养幡人	Gonfalon Nurturer
鬼气	Ghost Qi
鬼王	Ghost King
阴气	Yin Qi
魔修	Fiendish Cultivator
养幡人	Gonafalon Nurturer
鬼气	Ghost Qi
防御的结界	defensive barrier
兔王	Rabbit Monarch
掌门	sect master
堂主	hall master
万魔窟	Myriad Fiend Den
清灵之气	Spirit Cleansing Qi
现世	resurgence
凝聚出剑意	condense the sword intent
尊者	Supremacy
神识	Divine Perception
客卿	guest elder
外事堂	Outer Affairs Hall
术法	sorcery
法诀	Dharma spell
净化	purge
法符	Dharmic talisman
捏了个诀	produced a hand seal
迎缘峰	Yingyuan Peak
练器	weapon refinement
御兽	beast riding
术法剑术	sword techniques
玄海	Black Sea
奚秋	Xi Qiu
雷劫	Lightning Tribulation
青界	Azure World
无常毒煞	Venomous Witch
禁固	immobilizing lock
周天	one cycle
戚橙雨	Qi Chengyu
无常魔尊	Fiend Supremacy Impermanence
灵器	Spirit Artifact
太虚派	Grand Vacuity Sect
识真石	authenticity detector stone
本命法器	intrinsic dharmic artifact
通行玉牌	Passage Jade Token
炉鼎	human cauldron
寻踪符	tracking talisman
气息	aura
历练	experiential training
晋阶丹	cultivation boosting pills
练丹	refine pills
水灵根	Water Spirit Root
MDZZ	fucking retard
炉鼎	sexual enslavement
猫系COS	Cat-style COS
血煞之气	baneful Qi
防护阵	defensive array formation
万妖大王	Myriad Demon King
紫霞玄芝	Splendor Lingzhi
后期	late stage
灵植	spirit herb
结婴丹	neonate  formation pill
九尾血狐	nine-tailed blood fox
瞬移	teleporting
舔包	picking up loot
吃鸡	victory
隔绝阵	isolating array
血祭大阵	Blood Sacrifice Array
毕浩	Bi Hao
冥阴山	Ming Yin Mountain
甘子睿	Gan Zirui
废灵根	Maimed Spirit Root
灵根	Spirit Root
悟剑峰	Sword Comprehension Peak
玉鼎	Yu Ding
清韵	Qing Yun
吃货	foodie
烤鸡妹子	Roasted Chicken Gal
上青界	Upper Azure World
药丹峰	Elixir Peak
下青界	Lower Azure World
中青界	Middle Azure World
灭灵阵	Spiritual Annihilation Array
狸猫	Civet cat
万妖王	Myriad Demon King
本体	true form
卧槽	Holy shit!
雪儿	Snow Flake
御剑	sword-ride
主峰	main peak
狸猫	civet cat
仙气	Immortal Qi
典籍	classical texts
呈安	Cheng An
万妖殿	Myriad Demon Temple
万妖大会	Myriad Demon Congregation
宝库	treasury
游仙	traveling immortal
青尹	Qing Yin
下界	lower realm
上界	upper world
羿清真人	Perfected Yi Qing
化神尊者	Soul Formation Supremacies
储物袋	storage bag
上品	superior-grade
牛爸爸	Father Niu
息时间	three seconds
青岚	Qing Lan
随影术	shadow imitation
萝卜精	radish spirit
十二阶	twelfth level
兽王	beast king
内丹	internal core
火系	fire-elemental
原形	true form
草木灵	vegetation spirit
花练丹	Flower Spirit Pill
千叶草木灵	Thousand Leaves Vegetation Spirit
丹修	core cultivators
灵剑	spirit sword
仙魂	immortal soul
丹宗	Alchemical Sect
轩辕家	Xuan Yuan Family
仙宫	Immortal Pavilion
元神	primordial spirit
丹阳宗	Dan Yang Sect
仙骨	immortal bones
封绝	Encapsulation Seal
异火	Deviant Fire
练丹炉	elixir-refining cauldron
金仙碧涛	Golden Immortal Bitao
哼	Hmph
道号	Dao name
仙风道骨	sage-like
青亦	Qing Yi
仙丹	Immortal Pill
储丹室	Pill Storage Repository
化仙丹	Immortal Formation Pill
天雷	divine lightning
升仙丹	Immortal Formation Pill
仙植	immortal herb
火龙	inferno dragon
剑光	sword brilliance
红莲业火	Red Lotus Karmic Fire
金色巨剑	Great Golden Sword
灵兽	spirit beast
飞升	Immortal Ascension
仙门	immortal sect
大仙	Great Immortal
丹师	alchemist
祖宗	Patriarch
护山大阵	Protective Mountain Array
威压	suppression
余阳	Yu Yang
风系	wind-elemental
传送阵	transportation array
灵风	spirit wind
千叶灵花	Thousand Leaves Spirit Flower
妖女	demoness
小姐姐	Little Missy
上青城	Upper Azure Town
‘飘香楼	Fragrant Restaurant
灵脉	spirit vein
灵米	spirit rice
修仙	immortal cultivator
御兽	beast control
郁家	Yu Family
易家	Yi Family
印家	Yin Family
妖王殿	Demon Palace
郁红	Yu Hong
无敌派	Invincible Sect
命牌	life token
灵峰	spiritual peak
绝音阵	sound-proof array
广场	public square
思羽	Si Yu
断空涯	Sky Severance Cliff
振祥	Zhen Xiang
老贼	old crook
小红	Little Hong
定身诀	Immobilizing Seal
印天城	Yin Tian Town
虞蒙	Yu Meng
幻海	Mirage Sea
魔窟	fiend den
聚阴阵	array formation of Yin
魔尊	Fiend Supremacy
狮吼兽	Lion Roaring Beast
易峰	Yi Feng
雪银	Xue Yin
幻海之滨	Mirage Sea Shore
筋	meridian
轩辕禹	Xuan Yuanyu
印元飞	Yin Yuanfei
郁海珩	Yu Hai Heng
追魂楼	Soul Chasing Tower
华元城	Huayuan City
体修	body cultivator
枫影	Feng Ying
恒呦浅公司	Heng Youqian Company
宿主	host
迷魂阵	Soul Confundus Array
升仙塔	Immortal Ascension Pagoda
风刃	wind blade
散仙	itinerant cultivaor
束魂咒	Soul Binding Spell
明心宗	Bright Heart Sect
株织灵草	Weaved Rhizomed Spirit Grass
结印	conjured seals
幻肢	phantom balls
塑方城	Northern City
说完	With that said,
牛化云	Niu Huayun	Play of words, combination of the names of the two richest businessmen in China. Ma Huateng (Tencent CEO), and Ma Yun (Alibaba CEO). Ma means horse, and Niu here means cow.
黑气	black Qi
魔气	demonic Qi
炼魔塔	Demon Cultivating Pagoda
万兽峰	Myriad Beast Peak
契约兽	Contract Beast
背云兽	Cloud-Bearing Beast
白泽	Bai Ze
魔兽	Demon beast
神兽	Divine beast
魔蛟	Demonic wyrm
兽潮	Beast Tide
水族	Marines
玄灵花	Black Spirit Blssom
蛟龙	Flood dragon
魔蛟	Wyrm Demon
道侣	Dao partner
神族	divine race
魔族	demonic beast
薄飞平	Bo Feiping
曲双城	Qu Shuang City
荀立	Xun Li
